1 2 0 3 5
2 1 3 0 2
0 5 2 1 0
1 4 1 2 1
0 2 1 0 1
1 0 4 1 5